NO ./path_to_the_north_texture
SO ./path_to_the_south_texture
WE ./path_to_the_west_texture
EA ./path_to_the_east_texture

F 255,11,99
C 225,12,250

        1111111111111111111111111
        1000000000110000000000001
        1011000001110000000000001
        1001000000000000000000001
1111111110110000001110000000000001
110000000011000001110111111111111
111101111111110111000000100011111
11110111111111011101010010001
110000001101010111000000010001
10000000000010001100000010001
10000000000000001101010010001
11000001110101010111011110N0111
111101111111010111101111010001
11111111 1111111 111111111111
