NO ./path_to_the_north_texture
SO ./path_to_the_south_texture
WE ./path_to_the_west_texture
EA ./path_to_the_east_texture

C 144,224,239
F 204,197,176

1111111111111111111111111111
1100000000011000000000010001
1001000001110001000001000101
1001000000000101000011N10101
1101111111111111111111111101
1000000000000000000000000001
1111111111111111111111111111