NO ./path_to_the_north_texture
SO ./path_to_the_south_texture
WE ./path_to_the_west_texture
EA ./path_to_the_east_texture

C 144,224,239
F 204,197,176

1111111111111111111111111111
1000000000000000000000000001
1000000000000000000000000001
1000000000000000000000000001
100000000000001D1D1000000001
1000000000000000000000000001
1000000000010000000000000001
10000000000D0000000000000001
1000000000010000000000000001
1000000000000000000000000001
10000000000000000N0000000001
1111111111111111111111111111