NO ./path_to_the_north_texture
SO ./path_to_the_south_texture
WE ./path_to_the_west_texture
EA ./path_to_the_east_texture

F 255,11,99
C 225,12,250

1111111111111111111111111
11000000000110000000N00001
1011000001110000000000001111
1001000000000000000011001
111111111111111111111111
