NO textures/test/north.xpm
SO textures/test/south.xpm
WE textures/test/west.xpm
EA textures/test/east.xpm

F 255,11,99
C 225,12,250

1111111111111111111111111111
1100000000011000000000010001
1001000001110001000001000101
1001000000000101000011N10101
1101111111111111111111111101
1000000000000000000000000001
1111111111111111111111111111