NO textures/window.xpm
SO textures/pipes.xpm
WE textures/skull.xpm
EA textures/danger.xpm

C 144,224,239
F 204,197,176

111111111111111111111111111111111111111111111111111111111111111111111111111111
111111111111111111111111111111111111111111111111111111111111111111111111111111
111111111111111111111111111111111110000001111111111111111111111111111111111111
111111000011111111111111111111111110000001111111111111111111111111111111111111
111111000011111110000000000001000001000011111111111111111111111111111111111111
11111100000111111000000000000D00000D010111111111111111111111111111111111111111
111111000001111110000000000001000001000011111111111111111111111111111111111111
111111111111111111000111111110000001111111111111111111111111111111111111111111
111111000001110000000111111110000001111111111111111111111111111111111111111111
111111000001110000001111111111111D11111111111111111111111111111111111111111111
111111000001000000001111111111000011111111111111111111111111111111111111111111
111111000000000000001111111111000011111111111111111111111111111111111111111111
111111000001000000001111111111000011111111111111111111111111111111111111111111
111111000001111111111111111111000011111111111111111111111111111111111111111111
100011000001111111111111111111000011111111111111111111111111111111111111111111
100011111D11111111111111111111000001111111111111111111111111111111111111111111
100011110001111111111111111100001000011111111111111111111111111111111111111111
111D11110001111111111111111100001111111111111111111111111111111111111111111111
100011110001111111111111111000011111111111111111111111111111111111111111111111
100010001001111111111111111000011111111111111111111111111111111111111111111111
100000001001111111111111111111000011111111111111111111111111111111111111111111
100010001001111111111111111111000011111111111111111111111111111111111111111111
100011111D111111111111111111111D1111111111111111111111111111111111111111111111
100011000001111111111111111111000011111111111111111100000000000000000000001111
100011000001111111111111110000000001111111111111111100000000000000000000001111
100011000001111111111111110000000001111111111111111100000000000000000000001111
100001100001111111111111110000000010000000001000001100000000000000000000001111
100000D000011111111111111100000000D000000000D00000D100000000000000000000001111
100001100001111111111111110000000010000000001000001100000000000000000000001111
100011000001111111111111110000000011110000111100001100000000000000000000001111
100011000001111111111111110000000011111001111110001100000000000000000000001111
100011000001111111111111111111000011111001111110001111111000111000111000111111
100011111D111111111111111111111D1111111011111100011111111111111111111111111111
100011110001111111111111111111000011111011111100011111111111111111111111111111
100011110001111111111111111111000011111011111100011111111111111111111111111111
100010001001111111111111111111000011111011111100011111111111111111111111111111
100000001001111111111111111111000011111011111100011110101010111111111111111111
100010001001111111111111111111000011111011111100010000000000111111111111111111
1000111110011111111111111111110000111110111111000D0000000000111111111111111111
100011111001111111111111111111000011111011111100010000000000111111111111111111
100000000000100000111111111111000011111111111111101010101011111111111111111111
100000000000D00001011111111111000011111111111111111111111111111111111111111111
100000000001100011111111111111000011111111111111111111111111111111111111111111
111111111111111111111111111111000011111111111111111111111111111111111111111111
1111111111100100100111111111111D1111111111111111111111111111111111111111111111
111111111101001001111111110000100011000011111111111111111111111111111111111111
111111111111001111111111111000D000D0000111111111111111111111111111111111111111
111111111111111111111111111000100011000011111111111111111111111111111111111111
111111111111001111111111111000100001000011111111111111111111111111111111111111
111111111111001111111111111111100001111111111111111111111111111111111111111111
111111111111111111111111111010101001000011111111111111111111111111111111111111
1111111111111111111111111110D000D000011111111111111111111111111111111111111111
111111111111111111111111111010101001000011111111111111111111111111111111111111
111111111111111111111111111111100001111111111111111111111111111111111111111111
111111111111111111111111111000000000000011111111111111111111111111111111111111
111111111111111111111111111000000000000011111111111111111111111111111111111111
111111111111111111111111111000000N00000011111111111111111111111111111111111111
111111111111111111111111111111111111111111111111111111111111111111111111111111
