NO textures/window.xpm
SO textures/simonkraft/cobblestone.xpm
WE textures/simonkraft/soul_soil.xpm
EA textures/simonkraft/mossy_cobblestone1.xpm

C 144,224,239
F 204,197,176

1111111111111111111111111111
1000000000000000010001000001
10000000000000100D000D0W0001
10000100000001110100011D1001
100000000000001001000D000111
10000000000000000D0001000001
1111111111111111111111111111