NO textures/wolfenstein/grey_stone.xpm
SO textures/wolfenstein/purple_stone.xpm
WE textures/wolfenstein/red_brick.xpm
EA textures/wolfenstein/wood.xpm

F 220,100,0
C 225,30,0

        1111111111111111111111111
        100D000000110000000000001
        1011000001110000000000001
        10010000000D0000000000001
111111111011000001110000000000001
10000000001100000111011111D111111
1111D111111111D11100000010001
1111011111111011101010010001
11000000110101D11100000010001
10000000100000001100000010001
10000000D00000001101010010001
11000001110101011111011110N0111
11110111 1110101 101111010001
11111111 1111111 111111111111
