NO textures/test/north.xpm
SO textures/test/south.xpm
WE textures/test/west.xpm
EA textures/test/east.xpm

F 220,100,0
C 225,30,0


11111111111
10000000001
10000000001
10000100001
10100D000W1
10000100001
10000000001
10000000001
10000000001
10001D10001
10000000001
11111111111