WE  textures/wolfenstein/grey_stone.xpm
NO  textures/wolfenstein/purple_stone.xpm



SO textures/wolfenstein/red_brick.xpm

F      17,    38,     64

EA textures/wolfenstein/wood.xpm



C 218, 234, 235

1111111111111111111111111
10S0110000100000D00000001
1000110000000000111111001
1000110000000000110001001
1000D00000100000D00001001
1111111111111111111111111
